1111111111111111111111111111111111
10000P1C000000000000000010C0010C01
100000100100011100110C001000010101
1001111001000101001100000000000101
1C00000001000111001100111111111101
1010000001000000C01100110C00000001
1011110C01110011111100110000011111
1000C10001C00000C0000011000C0000E1
1111111111111111111111111111111111